%%%%%%%%%%%%%%%%%%%
%G.       G   ....%
%.% % %%%%%% %.%%.%
%.%o% %   o% %.o%.%
%.%%%.%  %%% %..%.%
%.....  P oo %..%G%
%%%%%%%%%%%%%%%%%%%
