%%%%%%%%%%%%%%%%
%P  ....... . G%
%%%%%%%%%%%%%%%%
